8 8 
1
1 4
1
4 3
==========
=........=
==.......=
=........=
=........=
=........=
=........=
=........=
=........=
==========
