0
0
==============================
=............................=
=............................=
=............................=
=............................=
===.====.===.=======.==......=
=............................=
=............................=
=............................=
=............................=
=............................=
=............................=
=............................=
=............................=
=............................=
=............................=
=............................=
=............................=
=............................=
=............................=
=............................=
=............................=
=............................=
=............................=
=............................=
=............................=
=............................=
=............................=
=............................=
==============================
