6 5
1
6 3
1
6 7
==========
=...=....=
=...=....=
=...=....=
=.=.=.==.=
=........=
=........=
=........=
=........=
==========
