5 6
3
1 1
8 3
8 8
2
1 8
8 1
==========
=........=
========.=
=......=.=
=.======.=
=......=.=
=.======.=
=.=......=
=........=
==========
